1,1,1,1,1,1,1,1
1,2,2,5,6,1,3,1
1,2,2,5,6,1,3,1
1,1,1,5,6,1,3,1
1,1,1,5,6,1,3,1
1,1,1,1,1,1,1,1